{
    "mapLocations": {
        "pallet" : [
            [ 
                [1, 1, 1, 1, 1, 1, 1, 1, 1, 1, 1, "route1", "route1", 1, 1, 1, 1, 1, 1, 1, 1, 1],
                [1, 0, 0, 0, 1, 0, 0, 0, 0, 0, 1, 8, 8, 1, 0, 0, 0, 0, 0, 1, 0, 1],
                [1, 1, 1, 1, 1, 1, 1, 1, 1, 1, 1, 0, 0, 1, 1, 1, 1, 1, 1, 1, 1, 1],
                [1, 1, 0, 0, 0, 0, 0, 0, 0, 0, 0, 0, 0, 0, 0, 0, 0, 0, 0, 0, 1, 1],
                [1, 1, 0, 0, 0, 1, 1, 1, 1, 0, 0, 0, 0, 1, 1, 1, 1, 0, 0, 0, 1, 1],
                [1, 1, 0, 0, 0, 1, "ashHouse1", 1, 1, 0, 0, 0, 0, 1, "rivalHouse", 1, 1, 0, 0, 0, 1, 1],
                [1, 1, 0, 0, 20, 1, 0, 1, 1, 0, 0, 0, 22, 1, 0, 1, 1, 0, 0, 0, 1, 1],
                [1, 1, 0, 0, 0, 0, 0, 0, 0, 0, 0, 0, 0, 0, 0, 0, 0, 0, 0, 0, 1, 1],
                [1, 1, 0, 0, 0, 0, 0, 0, 0, 0, 0, 0, 0, 0, 0, 0, 0, 0, 0, 0, 1, 1],
                [1, 1, 0, 0, 0, 60, 0, 0, 0, 0, 0, 1, 1, 1, 1, 1, 1, 0, 0, 0, 1, 1],
                [1, 1, 0, 0, 0, 1, 1, 1, 21, 0, 0, 1, 1, 1, 1, 1, 1, 0, 0, 0, 1, 1],
                [1, 1, 0, 0, 0, 0, 0, 0, 0, 0, 0, 1, 1, "oakLab", 1, 1, 1, 0, 0, 0, 1, 1],
                [1, 1, 0, 0, 0, 0, 0, 0, 0, 0, 0, 1, 1, 0, 1, 1, 1, 0, 0, 0, 1, 1],
                [1, 1, 0, 0, 0, 0, 0, 0, 0, 0, 0, 0, 0, 0, 0, 0, 0, 0, 0, 0, 1, 1],
                [1, 1, 0, 0, 0, 0, 0, 0, 0, 0, 0, 1, 1, 1, 23, 1, 1, 0, 0, 0, 1, 1],
                [1, 1, 0, 0, 0, 3, 3, 3, 3, 0, 0, 0, 0, 0, 0, 0, 0, 0, 0, 0, 1, 1],
                [1, 1, 0, 0, 0, 3, 3, 3, 3, 0, 0, 61, 0, 0, 0, 0, 0, 0, 0, 0, 1, 1],
                [1, 1, 0, 0, 0, 3, 3, 3, 3, 0, 0, 0, 0, 0, 0, 0, 0, 0, 0, 0, 1, 1],
                [1, 1, 1, 0, 0, 3, 3, 3, 3, 1, 1, 1, 1, 1, 1, 1, 1, 1, 1, 1, 1, 1],
                [1, 1, 1, 1, 1, 1, 1, 1, 1, 1, 1, 1, 1, 1, 1, 1, 1, 1, 1, 1, 1, 1]
            ],
            {
                "ashHouse1": [7, 6, "down"],
                "rivalHouse": [7, 14, "down"],
                "oakLab": [13, 13, "down"],
                "route1": [2, 11, "down"]
            }
        ],
        "ashHouse1" : [
            [
                [1, 1, 1, 1, 1, 1, 1, 1, 1, 1],
                [1, 1, 1, 1, 1, 1, 1, 1, 1, 1],
                [1, 1, 1, 0, 1, 0, 0, 0, "ashHouse2", 1],
                [1, 0, 0, 0, 0, 0, 0, 0, 0, 1],
                [1, 0, 0, 0, 0, 0, 0, 0, 0, 1],
                [1, 0, 0, 1, 1, 1, 60, 0, 0, 1],
                [1, 0, 0, 1, 1, 1, 1, 0, 0, 1],
                [1, 0, 0, 0, 0, 0, 0, 0, 0, 1],
                [1, 0, 0, 0, 0, 0, 0, 0, 0, 1],
                [1, 1, 1, "pallet", "pallet", 1, 1, 1, 1, 1]
            ],
            {
                "pallet": [8, 3, "up"],
                "ashHouse2": [2, 7, "left"]
            }
        ],
        "ashHouse2" : [
            [
                [1, 1, 1, 1, 1, 1, 1, 1, 1, 1],
                [1, 1, 1, 1, 1, 1, 1, 1, 1, 1],
                [1, 1, 1, 1, 0, 0, 0, 0, "ashHouse1", 1],
                [1, 0, 0, 0, 0, 0, 0, 0, 0, 1],
                [1, 0, 0, 0, 0, 0, 0, 0, 0, 1],
                [1, 0, 0, 0, 1, 0, 0, 0, 0, 1],
                [1, 0, 0, 0, 1, 0, 0, 0, 0, 1],
                [1, 1, 0, 0, 0, 0, 0, 1, 0, 1],
                [1, 1, 0, 0, 0, 0, 0, 1, 0, 1],
                [1, 1, 1, 1, 1, 1, 1, 1, 1, 1]
            ],
            {
                "ashHouse1": [2, 7, "left"]
            }
        ],
        "rivalHouse" : [
            [
                [1, 1, 1, 1, 1, 1, 1, 1, 1, 1],
                [1, 1, 1, 1, 1, 1, 1, 1, 1, 1],
                [1, 1, 1, 0, 0, 0, 0, 0, 1, 1],
                [1, 0, 0, 0, 0, 0, 0, 0, 0, 1],
                [1, 0, 0, 60, 1, 1, 1, 0, 0, 1],
                [1, 0, 0, 1, 1, 1, 1, 0, 0, 1],
                [1, 0, 0, 0, 0, 0, 0, 0, 0, 1],
                [1, 1, 0, 0, 0, 0, 0, 0, 1, 1],
                [1, 1, 0, 0, 0, 0, 0, 0, 1, 1],
                [1, 1, 1, "pallet", "pallet", 1, 1, 1, 1, 1]
            ],
            {
                "pallet": [8, 3, "up"]
            }
        ],
        "oakLab" : [
            [
                [1, 1, 1, 1, 1, 1, 1, 1, 1, 1, 1, 1],
                [1, 1, 1, 1, 1, 1, 1, 1, 1, 1, 1, 1],
                [1, 1, 1, 1, 1, 0, 0, 1, 1, 1, 1, 1],
                [1, 0, 0, 0, 0, 0, 63, 0, 0, 0, 0, 1],
                [1, 0, 0, 0, 0, 0, 0, 70, 71, 72, 0, 1],
                [1, 0, 0, 0, 0, 0, 0, 0, 0, 0, 0, 1],
                [1, 0, 0, 0, 0, 0, 0, 0, 0, 0, 0, 1],
                [1, 1, 1, 1, 1, 0, 0, 1, 1, 1, 1, 1],
                [1, 1, 1, 1, 1, 0, 0, 1, 1, 1, 1, 1],
                [1, 0, 0, 0, 0, 0, 0, 0, 0, 0, 0, 1],
                [1, 0, 0, 0, 0, 0, 0, 0, 0, 61, 0, 1],
                [1, 0, 62, 60, 0, 0, 0, 0, 0, 0, 0, 1],
                [1, 0, 0, 0, 0, 0, 0, 0, 0, 0, 0, 1],
                [1, 1, 1, 1, 1, "pallet", "pallet", 1, 1, 1, 1, 1]
            ],
            {
                "pallet": [12, 5, "up"]
            }
        ],
        "route1" : [
            [
                [1, 1, 1, 1, 1, 1, 1, 1, 1, "finalFourLair", "finalFourLair", 1, 1, 1, 1, 1, 1, 1, 1, 1],
                [1, 0, 1, 0, 0, 0, 0, 0, 1, 8, 8, 1, 0, 0, 0, 0, 0, 1, 0, 1],
                [1, 0, 1, 1, 1, 1, 1, 1, 1, 0, 0, 1, 1, 1, 1, 1, 1, 1, 0, 1],
                [1, 0, 1, 0, 0, 0, 0, 0, 62, 0, 0, 0, 0, 0, 0, 0, 0, 1, 0, 1],
                [1, 0, 1, 0, 0, 0, 0, 0, 0, 0, 0, 0, 0, 0, 0, 0, 0, 1, 0, 1],
                [1, 0, 1, 0, 0, 0, 0, 0, 1, 0, 0, 0, 0, 0, 0, 0, 0, 1, 0, 1],
                [1, 0, 1, 5, 5, 5, 5, 5, 1, 5, 5, 5, 0, 0, 0, 0, 0, 1, 0, 1],
                [1, 0, 1, 0, 0, 0, 0, 0, 1, 4, 4, 4, 4, 4, 4, 4, 4, 1, 0, 1],
                [1, 0, 1, 0, 0, 0, 0, 0, 1, 4, 4, 4, 4, 4, 4, 4, 4, 1, 0, 1],
                [1, 0, 1, 0, 0, 0, 0, 0, 1, 4, 4, 4, 4, 4, 4, 4, 4, 1, 0, 1],
                [1, 0, 1, 5, 5, 5, 5, 5, 1, 4, 4, 4, 4, 4, 4, 4, 4, 1, 0, 1],
                [1, 0, 1, 0, 0, 0, 0, 0, 0, 0, 0, 0, 0, 0, 0, 0, 0, 1, 0, 1],
                [1, 0, 1, 0, 0, 0, 0, 0, 0, 0, 0, 0, 0, 0, 0, 0, 0, 1, 0, 1],
                [1, 0, 1, 0, 0, 0, 0, 0, 0, 0, 0, 0, 0, 4, 4, 4, 4, 1, 0, 1],
                [1, 0, 1, 1, 1, 5, 5, 5, 5, 1, 1, 1, 1, 4, 61, 4, 4, 1, 0, 1],
                [1, 0, 1, 0, 0, 0, 0, 0, 0, 0, 0, 0, 0, 4, 4, 4, 4, 1, 0, 1],
                [1, 0, 1, 0, 0, 0, 0, 0, 0, 0, 0, 0, 0, 4, 4, 4, 4, 1, 0, 1],
                [1, 0, 1, 0, 0, 0, 0, 0, 0, 0, 0, 0, 0, 0, 0, 0, 0, 1, 0, 1],
                [1, 0, 1, 0, 0, 0, 0, 0, 0, 0, 0, 0, 0, 0, 0, 0, 0, 1, 0, 1],
                [1, 0, 1, 0, 0, 0, 0, 0, 0, 0, 0, 0, 0, 0, 0, 0, 0, 1, 0, 1],
                [1, 0, 1, 5, 0, 5, 5, 5, 0, 5, 5, 5, 5, 5, 5, 5, 5, 1, 0, 1],
                [1, 0, 1, 0, 0, 0, 0, 0, 0, 0, 0, 0, 0, 0, 0, 0, 0, 1, 0, 1],
                [1, 0, 1, 0, 0, 0, 0, 0, 0, 0, 0, 0, 0, 0, 0, 0, 0, 1, 0, 1],
                [1, 0, 1, 0, 0, 0, 0, 0, 0, 0, 0, 4, 4, 4, 4, 0, 0, 1, 0, 1],
                [1, 0, 1, 1, 1, 1, 1, 1, 1, 1, 1, 4, 4, 4, 4, 5, 5, 1, 0, 1],
                [1, 0, 1, 0, 0, 0, 0, 0, 0, 0, 0, 4, 4, 4, 4, 0, 0, 1, 0, 1],
                [1, 0, 1, 0, 60, 0, 0, 0, 0, 0, 0, 4, 4, 4, 4, 0, 0, 1, 0, 1],
                [1, 0, 1, 0, 0, 0, 0, 0, 0, 0, 0, 0, 0, 0, 0, 0, 0, 1, 0, 1],
                [1, 0, 1, 5, 5, 0, 0, 0, 1, 5, 5, 5, 5, 5, 5, 5, 5, 1, 0, 1],
                [1, 0, 1, 0, 0, 4, 4, 4, 4, 0, 0, 0, 0, 4, 4, 4, 4, 1, 0, 1],
                [1, 0, 1, 0, 0, 4, 4, 4, 4, 0, 0, 0, 0, 4, 4, 4, 4, 1, 0, 1],
                [1, 0, 1, 4, 4, 4, 4, 0, 0, 0, 0, 4, 4, 4, 4, 0, 0, 1, 0, 1],
                [1, 0, 1, 4, 4, 4, 4, 0, 0, 0, 0, 4, 4, 4, 4, 0, 0, 1, 0, 1],
                [1, 0, 1, 1, 1, 1, 1, 1, 1, 4, 4, 1, 1, 1, 1, 1, 1, 1, 0, 1],
                [1, 0, 1, 0, 0, 0, 0, 0, 1, 4, 4, 1, 0, 0, 0, 0, 0, 1, 0, 1],
                [1, 0, 1, 0, 0, 0, 0, 0, 1, 4, 4, 1, 0, 0, 0, 0, 0, 1, 0, 1],
                [1, 0, 1, 0, 0, 0, 0, 0, 1, 4, 4, 1, 0, 0, 0, 0, 0, 1, 0, 1],
                [1, 1, 1, 1, 1, 1, 1, 1, 1, "pallet", "pallet", 1, 1, 1, 1, 1, 1, 1, 1, 1]
            ],
            {
                "pallet" : [36, 9, "up"],
                "finalFourLair" : [1, 9, "down"]
            }
        ],
        "finalFourLair" : [
            [
                [1, 1, 1, 1, 1, 1, 1, 1, 1, 1, 1, 1],
                [1, 1, 1, 1, 1, 1, 1, 1, 1, 1, 1, 1],
                [1, 1, 0, 0, 60, 61, 62, 63, 0, 0, 1, 1],
                [1, 1, 0, 0, 0, 0, 0, 0, 0, 0, 1, 1],
                [1, 1, 1, 1, 1, 0, 0, 1, 1, 1, 1, 1],
                [1, 1, 0, 0, 0, 0, 0, 0, 0, 0, 1, 1],
                [1, 1, 0, 1, 0, 0, 1, 1, 1, 0, 1, 1],
                [1, 1, 0, 0, 0, 0, 0, 0, 0, 0, 1, 1],
                [1, 1, 0, 1, 0, 0, 1, 1, 1, 0, 1, 1],
                [1, 1, 0, 0, 0, 0, 0, 0, 0, 0, 1, 1],
                [1, 1, 1, 1, 1, 0, 0, 1, 1, 1, 1, 1],
                [1, 0, 0, 0, 1, 0, 0, 1, 0, 0, 0, 1],
                [1, 1, 1, 1, 1, "route1", "route1", 1, 1, 1, 1, 1]
            ],
            {
                "route1" : [11, 5, "up"]
            }
        ]
    }
}